NO ./textures/n.xpm
SO ./textures/s.xpm
WE ./textures/w.xpm
EA ./textures/e.xpm
F 100,100,100
C 200,200,200
11111111
10010001
10000101
10000001
100S0101
10000001
11111111